11111111111111111111
1C1000000000E0000001
10101001000000010101
1010100100001C1C0101
10P00C00000001000001
11111111111111111111