11111111111111111111
1C100000000000000001
10101001000000010101
1010100100001C1C0101
10P00C0000000100E001
11111111111111111111