1111111111
1111111C11
111E111111
1111P11111
1111111111