1111111111111111111111111111111111111111111111111111
1E1000000000000000000C000000000000000000000000000001
1010010100100000101001000000010100000000010100101011
1010010100100000101001000000010100000000010100101011
10100101001000001010010000C0010100000000010100101011
1010010100100000101001000000010100000000010100101011
1010010100100000101001000000010100000000010100101011
1010010100100000101001000000110100000000010100101011
10100101001000001010010CCCC1C01010000000001010010101
1000P10100100000101001000000010100000000010100101011
1010010100100000101001000000010100000000010100101011
1010010100100000101001000000010100000000010100101011
1010010100100000101001000000010100000000010100101011
10100101001000C0101001000000010100000000010100101011
1010010100100000101001000000010100000000010100101011
1111111111111111111111111111111111111111111111111111