111111111111111111111111111111111111111111111111111111111111111
1E1000000000000000000C00000000000000000000000000000000000000001
101001010010000010100100000001010000000101000000010100000001011
101001010010000010100100000001010000000101000000010100000001011
101001001010101000100100000001010000000101000000010100000001011
1P0000000C00C00000000000000000010000000001000000000100000000011
111111111111111111111111111111111111111111111111111111111111111