1111111111111111111111111111111111111111111111111111
1E1000000000000C00000C00000000000000000000C00000C001
100000000000000C00000C00000000000000000000C00000C001
100000000000000C00000C00000000000000000000C00000C001
1010010100100000101001000000010100000000000C00000C01
1010010100100000101001000000010100000000000C00000C01
1010010010101010001001000000010100000000000C00000C01
1P0000000C00C0000000000000000000C0000000000C00000C01
1111111111111111111111111111111111111111111111111111