1111111111111
1E01000000001
1C00011111001
1P00110000001
1111111111111